100 Years of Lynchings	Ralph Ginzburg
1000 Record Covers	Michael Ochs-Patrick Javault-Ulrike Wasel
A Book of Common Prayer	Joan Didion
A Changeling for All Seasons (Changeling Seasons #1)	Angela Knight-Sahara Kelly-Judy Mays-Marteeka Karland-Kate Douglas-Shelby Morgen-Lacey Savage-Kate Hill-Willa Okati
A Long Shadow (Inspector Ian Rutledge  #8)	Charles Todd
A Shadow in Summer (Long Price Quartet  #1)	Daniel Abraham
A Short History of Nearly Everything	Bill Bryson-William Roberts
A War Like No Other: How the Athenians & Spartans Fought the Peloponnesian War	Victor Davis Hanson
A Wrinkle in Time: A Guide for Using "A Wrinkle in Time" in the Classroom	John Carratello-Patty Carratello-Theresa Wright
A Wrinkle in Time: With Related Readings (A Wrinkle in Time Quintet #1)	Madeleine L'Engle
Active Literacy Across the Curriculum: Strategies for Reading  Writing  Speaking  and Listening	Heidi Hayes Jacobs
Against the Day	Thomas Pynchon
Agile Web Development with Rails: A Pragmatic Guide	Dave Thomas-David Heinemeier Hansson-Leon Breedt-Mike Clark-Thomas  Fuchs-Andreas  Schwarz
Always Enough: God's Miraculous Provision Among the Poorest Children on Earth	Heidi Baker-Rolland Baker
America (The Book): A Citizen's Guide to Democracy Inaction	Jon Stewart-Ben Karlin-David Javerbaum-Rich Bloomquist-Steve Bodow-Tim Carvell-Eric Drysdale-J.R. Havlan-Scott Jacobson-Tom Johnson-Rob Kutner-Chris Regan-Jason Reich-Jason Ross-Stephen Colbert-Samantha Bee-Rob Corddry-Brendan Hay-Ed Helms
Americana	Don DeLillo
Angels & Demons (Robert Langdon  #1)	Dan Brown
Anna Karenina	Leo Tolstoy-Amy Mandelker-Constance Garnett
Anna Karenina	Leo Tolstoy-Constance Garnett-Amy Mandelker
Anna Karenina	Leo Tolstoy-David Magarshack-Priscilla Meyer
Anna Karenina	Leo Tolstoy-Louise Maude-Aylmer Maude
Anna Karenina	Leo Tolstoy-Richard Pevear-Larissa Volokhonsky
Anna Karenina	Leo Tolstoy-Richard Pevear-Larissa Volokhonsky-John Bayley
Annals of the Former World	John McPhee
Another Bullshit Night in Suck City	Nick Flynn
Anthem	Ayn Rand
Artesia: Adventures in the Known World	Mark Smylie
Atlas Shrugged	Ayn Rand-Leonard Peikoff
Been Down So Long It Looks Like Up To Me	Richard FariÃ±a-Thomas Pynchon
Best of London (Lonely Planet Best Of)	Lonely Planet-Sarah Johnstone-Steve Fallon
Bowling Alone: The Collapse and Revival of American Community	Robert D. Putnam
Boys of Summer	Julie Elizabeth Leto-Leslie Kelly-Kimberly Raye
Capitalism: The Unknown Ideal	Ayn Rand-Nathaniel Branden-Alan Greenspan-Robert Hessen
Changeling (Changeling  #1)	Delia Sherman
Chapterhouse: Dune (Dune Chronicles #6)	Frank Herbert
Children of Dune (Dune Chronicles #3)	Frank Herbert
Cien aÃ±os de soledad	Gabriel GarcÃ­a MÃ¡rquez
Cien aÃ±os de soledad	Gabriel GarcÃ­a MÃ¡rquez
Cien aÃ±os de soledad	Gabriel GarcÃ­a MÃ¡rquez
City of Glass (The New York Trilogy  #1)	Paul Auster
CliffsNotes on Tolstoy's Anna Karenina	Marianne Sturman-Leo Tolstoy
Collapse of Complex Societies	Joseph A. Tainter
Collapse: How Societies Choose to Fail or Succeed	Jared Diamond
Collected Stories	Gabriel GarcÃ­a MÃ¡rquez-Gregory Rabassa-J.S. Bernstein
Coming Into the Country	John McPhee
Cooking with Fernet Branca (Gerald Samper  #1)	James Hamilton-Paterson
Cosmopolis	Don DeLillo
Cryptonomicon	Neal Stephenson
CrÃ³nica de una muerte anunciada	Gabriel GarcÃ­a MÃ¡rquez
Da Vinci Code (Robert Langdon  #2)	Dan Brown-Daniel Roche
Dalit: The Black Untaouchables of India	V.T. Rajshekar-Y.N. Kly
Daniel Deronda	George Eliot-Edmund White
Deception Point	Dan Brown
Del amor y otros demonios	Gabriel GarcÃ­a MÃ¡rquez
Democracy	Joan Didion
Destroy  She Said	Marguerite Duras-Barbara Bray-Helen Lane Cumberford
Digging to America	Anne Tyler
Dinner with Anna Karenina	Gloria Goldreich
Douglas Adams's Starship Titanic	Terry Jones
Dreamer of Dune: The Biography of Frank Herbert	Brian Herbert
Dune Messiah (Dune Chronicles #2)	Frank Herbert
El perfume: Historia de un asesino	Patrick SÃ¼skind
Emotional Design: Why We Love (or Hate) Everyday Things	Donald A. Norman
First Impressions	Nora Roberts
For the New Intellectual: The Philosophy of Ayn Rand	Ayn Rand
Fullmetal Alchemist  Vol. 1 (Fullmetal Alchemist  #1)	Hiromu Arakawa-Akira Watanabe
Fullmetal Alchemist  Vol. 2 (Fullmetal Alchemist  #2)	Hiromu Arakawa-Akira Watanabe
Fullmetal Alchemist  Vol. 3 (Fullmetal Alchemist  #3)	Hiromu Arakawa-Akira Watanabe
Fullmetal Alchemist  Vol. 4 (Fullmetal Alchemist  #4)	Hiromu Arakawa-Akira Watanabe
Fullmetal Alchemist  Vol. 8 (Fullmetal Alchemist  #8)	Hiromu Arakawa-Akira Watanabe
Fullmetal Alchemist  Vol. 9 (Fullmetal Alchemist  #9)	Hiromu Arakawa-Akira Watanabe
Geisha of Gion	Mineko Iwasaki-Rande Brown
Getting Results with Curriculum Mapping	Heidi Hayes Jacobs
Ghosts (The New York Trilogy  #2)	Paul Auster
Giving Good Weight	John McPhee
God Emperor of Dune (Dune Chronicles  #4)	Frank Herbert
Golding's Lord of the Flies (Cliffs Notes)	Maureen Kelly-CliffsNotes-William Golding
Golgotha (Cryptonomicon  #3)	Neal Stephenson
Gravity's Rainbow	Thomas Pynchon
Gravity's Rainbow	Thomas Pynchon
Great Jones Street	Don DeLillo
Growing Up Untouchable in India: A Dalit Autobiography	Vasant Moon-Gail Omvedt-Eleanor Zelliot
Guidebook to Zen and the Art of Motorcycle Maintenance	Ronald L. DiSanto-Thomas J. Steele
Guts: The True Stories behind Hatchet and the Brian Books	Gary Paulsen
HTML  XHTML  and CSS (Visual Quickstart Guide)	Elizabeth Castro
Harrington on Hold 'em: Expert Strategy for No-Limit Tournaments  Volume I: Strategic Play	Dan Harrington-Bill Robertie
Harrington on Hold 'em: Expert Strategy for No-Limit Tournaments  Volume II: The Endgame	Dan Harrington-Bill Robertie
Harry Potter Boxed Set  Books 1-5 (Harry Potter  #1-5)	J.K. Rowling-Mary GrandPrÃ©
Harry Potter Collection (Harry Potter  #1-6)	J.K. Rowling
Harry Potter and the Chamber of Secrets (Harry Potter  #2)	J.K. Rowling
Harry Potter and the Half-Blood Prince (Harry Potter  #6)	J.K. Rowling-Mary GrandPrÃ©
Harry Potter and the Order of the Phoenix (Harry Potter  #5)	J.K. Rowling-Mary GrandPrÃ©
Harry Potter and the Prisoner of Azkaban (Harry Potter  #3)	J.K. Rowling-Mary GrandPrÃ©
Harry Potter and the Sorcerer's Stone (Harry Potter  #1)	J.K. Rowling-Mary GrandPrÃ©
Hatchet	Gary Paulsen
Hatchet Jobs: Writings on Contemporary Fiction	Dale Peck
Hatchet: A Guide for Using "Hatchet" in the Classroom	Donna Ickes-Edward Sciranko-Keith Vasconcelles
Heidi	Johanna Spyri-Beverly Cleary-Angelo  Rinaldi
Heirs of General Practice	John McPhee
Henry Miller on Writing	Henry Miller-Thomas H. Moore
Heretics of Dune (Dune Chronicles  #5)	Frank Herbert
Heretics of Dune (Dune Chronicles #5)	Frank Herbert
How to Buy  Sell & Profit on eBay: Kick-Start Your Home-Based Business in Just Thirty Days	Adam Ginsberg
Hunters Of Dune (Dune Chronicles  #7)	Brian Herbert-Kevin J. Anderson
I am Charlotte Simmons	Tom Wolfe
I'm a Stranger Here Myself: Notes on Returning to America After Twenty Years Away	Bill Bryson
In a Sunburned Country	Bill Bryson
Interface	Neal Stephenson-George F. Jewsbury-Stephen  Bury
J.R.R. Tolkien 4-Book Boxed Set: The Hobbit and The Lord of the Rings	J.R.R. Tolkien
Jesus the Son of Man	Kahlil Gibran-Ø¬Ø¨Ø±Ø§Ù† Ø®Ù„ÙŠÙ„ Ø¬Ø¨Ø±Ø§Ù†
Jitterbug Perfume	Tom Robbins
Job: A Comedy of Justice	Robert A. Heinlein
Jungle Love	Margaret Johnson-Philip Prowse
Kahlil Gibran: His Life and World	Jean Gibran-Ø¬Ø¨Ø±Ø§Ù† Ø®Ù„ÙŠÙ„ Ø¬Ø¨Ø±Ø§Ù†-Kahlil Gibran
Killing Yourself to Live: 85% of a True Story	Chuck Klosterman
King Lear	William Shakespeare
King Lear (No Fear Shakespeare)	William Shakespeare-SparkNotes
L'Amant de la Chine du Nord	Marguerite Duras
L'alchimiste	Paulo Coelho-Jean Orecchioni
LOGO Lounge: 2 000 International Identities by Leading Designers	Catharine M. Fishel-Bill Gardner
La Place de la Concorde Suisse	John McPhee
Le RÃ©seau Kinakuta (Cryptonomicon  #2)	Neal Stephenson
Letters of Ayn Rand	Ayn Rand-Michael S. Berliner-Leonard Peikoff
Leviathan	Paul Auster
Libra	Don DeLillo
Lincoln at Gettysburg: The Words That Remade America	Garry Wills
Literature Circle Guide: A Wrinkle in Time	Tara MacCarthy
Living to Tell the Tale	Gabriel GarcÃ­a MÃ¡rquez-Edith Grossman
London	Lonely Planet-Steve Fallon-Pat Yale
London: City Guide (Lonely Planet City Guide)	Lonely Planet-Sarah Johnstone-Tom Masters
Lonely Planet Londres	Lonely Planet-Sarah Johnstone-Tom Masters
Long Way Round: Chasing Shadows Across the World	Ewan McGregor-Charley Boorman-Robert Uhlig
Lord of the Flies	William Golding
Lord of the Flies	William Golding-Ben Gibson-E.M. Forster-Edmund L. Epstein
Love As A Foreign Language #5	J. Torres-Eric  Kim
Love Letters	Kahlil Gibran-Suheil Bushrui-Salma H. Al-Kuzbari
Lovely in Her Bones (Elizabeth MacPherson  #2)	Sharyn McCrumb
Macbeth (Graphic Shakespeare)	William Shakespeare-Von
Mao II	Don DeLillo
Mapping the Big Picture: Integrating Curriculum & Assessment K-12	Heidi Hayes Jacobs
Mason & Dixon	Thomas Pynchon
Memoirs Of A Geisha	Arthur Golden
Memoirs of a Geisha	Arthur Golden
Memoirs of a Geisha	Arthur Golden
Memoirs of a Geisha	Arthur Golden
Memoirs of a Geisha	Arthur Golden
Memoirs of a Geisha: A Portrait of the Film	David        James-Peggy Mulloy-Rob Marshall-Arthur Golden
Memoria de mis putas tristes	Gabriel GarcÃ­a MÃ¡rquez
Miami Blues (Hoke Mosely #1)	Charles Willeford-Elmore Leonard
Modern Latin America	Thomas E. Skidmore-Peter H. Smith
Moisson mortelle	Leonard Goldberg
Molly Hatchet - 5 of the Best	Molly Hatchet
Moon Palace	Paul Auster
Mostly Harmless (Hitchhiker's Guide to the Galaxy  #5)	Douglas Adams
Motorcycle Basics Techbook	John Harold Haynes
My Inventions	Nikola Tesla
Naked Pictures of Famous People	Jon Stewart
Natural Cures "They" Don't Want You to Know about	Kevin Trudeau
Neither Here nor There: Travels in Europe	Bill Bryson
Neon Lit: Paul Auster's City of Glass	Paul Karasik-David Mazzucchelli-Paul Auster-Bob Callahan
New Hope for the Dead (Hoke Mosely #2)	Charles Willeford-James Lee Burke
Nexus (The Rosy Crucifixion  #3)	Henry Miller
Nikola Tesla: A Spark of Genius	Carol Dommermuth-Costa
No Price Too High: A Pentecostal Preacher Becomes Catholic - The Inspirational Story of Alex Jones as Told to Diane Hanson	Alex C. Jones-Diane M. Hanson-Stephen K. Ray
Notes from a Small Island	Bill Bryson
Odalisque (The Baroque Cycle  Vol. 1  Book 3)	Neal Stephenson
Of Mice and Men	John Steinbeck
Of Mice and Men	John Steinbeck-Jim Taylor
Off the Main Sequence: The Other Science Fiction Stories of Robert A. Heinlein	Robert A. Heinlein
On Beyond Zebra!	Dr. Seuss
On Bullshit	Harry G. Frankfurt
Once Upon a Cool Motorcycle Dude	Kevin O'Malley-Carol Heyer-Scott Goto
One Hundred Years of Solitude	Gabriel GarcÃ­a MÃ¡rquez-Gregory Rabassa
Out to Eat London 2002 (Lonely Planet Out to Eat)	Lonely Planet-Mark Honan
Perfume: The Story of a Murderer	Patrick SÃ¼skind-John E. Woods
Play It as It Lays	Joan Didion-David Thomson
Poetry for Young People: Edward Lear	Edward Lear-Laura Huliska-Beith-Edward Mendelson
Pompeii	Robert   Harris
Power of an Hour: Business and Life Mastery in One Hour a Week	Dave Lakhani
Programming Ruby: The Pragmatic Programmers' Guide	Dave Thomas-Chad Fowler-Andy Hunt
Pure and Simple: The Extraordinary Teachings of a Thai Buddhist Laywoman	Upasika Kee Nanayon-Thanissaro Bhikkhu
Pyramids of Montauk: Explorations in Consciousness	Peter Moon-Preston B. Nichols-Nina Helms
Quicksilver (The Baroque Cycle  #1)	Neal Stephenson
Quiet Days in Clichy	Henry Miller
Rails Cookbook: Recipes for Rapid Web Development with Ruby	Rob Orsini
Reefer Madness: Sex  Drugs  and Cheap Labor in the American Black Market	Eric Schlosser
Reinventing the Enemy's Language: Contemporary Native Women's Writings of North America	Joy Harjo-Gloria Bird-Beth Cuthand-Valerie Martinez-Patricia Blanco
Rereading America: Cultural Contexts for Critical Thinking and Writing	Gary Colombo-Bonnie Lisle
Rising from the Plains	John McPhee
Ruby Ann's Down Home Trailer Park BBQin' Cookbook	Ruby Ann Boxcar
Ruby Ann's Down Home Trailer Park Cookbook	Ruby Ann Boxcar
Ruby Cookbook	Lucas Carlson-Leonard Richardson
Running Dog	Don DeLillo
Sailing Alone Around the Room: New and Selected Poems	Billy Collins
Sailing for Dummies	J.J. Isler-Peter Isler
Sailing from Byzantium: How a Lost Empire Shaped the World	Colin  Wells
Salmon of Doubt: Hitchhiking the Galaxy One Last Time	Douglas Adams-Christopher Cerf
Sand and Foam	Kahlil Gibran-Ø¬Ø¨Ø±Ø§Ù† Ø®Ù„ÙŠÙ„ Ø¬Ø¨Ø±Ø§Ù†
Sex  Drugs  and Cocoa Puffs: A Low Culture Manifesto	Chuck Klosterman
Sexus (The Rosy Crucifixion  #1)	Henry Miller
Sideswipe: A Hoke Moseley Novel	Charles Willeford-Lawrence Block
Simply Beautiful Beaded Jewelry	Heidi Boyd
Simply Beautiful Beading: 53 Quick and Easy Projects	Heidi Boyd
Slow Learner: Early Stories	Thomas Pynchon
Snow Crash	Neal Stephenson
Snow Crash	Neal Stephenson-Joachim KÃ¶rber
Starting an eBay Business for Dummies	Marsha Collier
Stranger in a Strange Land	Robert A. Heinlein
Tesla Papers	Nikola Tesla-David Hatcher Childress
The 5 Love Languages / The 5 Love Languages Journal	Gary Chapman
The Air-Conditioned Nightmare	Henry Miller
The Alchemist	Paulo Coelho-Alan R. Clarke-James Noel Smith
The Alchemist	Paulo Coelho-Alan R. Clarke-Ã–zdemir Ä°nce
The Beloved: Reflections on the Path of the Heart	Kahlil Gibran-John Walbridge-Robin Waterfield
The Big U	Neal Stephenson
The Broken Wings	Kahlil Gibran-Ø¬Ø¨Ø±Ø§Ù† Ø®Ù„ÙŠÙ„ Ø¬Ø¨Ø±Ø§Ù†-Anthony R. Ferris
The Brooklyn Follies	Paul Auster
The Changeling	Kate Horsley
The Changeling	Zilpha Keatley Snyder
The Changeling (Daughters of England  #15)	Philippa Carr
The Changeling Sea	Patricia A. McKillip
The Cobweb	Neal Stephenson-J. Frederick George
The Collapse of the Common Good: How America's Lawsuit Culture Undermines Our Freedom	Philip K. Howard
The Coming Economic Collapse: How You Can Thrive When Oil Costs $200 a Barrel	Stephen Leeb-Glen C. Strathy
The Confusion (The Baroque Cycle  #2)	Neal Stephenson
The Control of Nature	John McPhee
The Crying of Lot 49	Thomas Pynchon
The Da Vinci Code	Dan Brown
The Da Vinci Code (Robert Langdon  #2)	Dan Brown
The Death of Ivan Ilych And Other Stories	Leo Tolstoy-Hugh McLean
The Design of Everyday Things	Donald A. Norman
The Diamond Age: Or  A Young Lady's Illustrated Primer	Neal Stephenson
The Door Into Summer	Robert A. Heinlein
The Egypt Game	Zilpha Keatley Snyder
The Elegant Universe: Superstrings  Hidden Dimensions  and the Quest for the Ultimate Theory	Brian Greene
The Evidence-Based Social Work Skills Book	Barry R. Cournoyer
The Fellowship of the Ring (The Lord of the Rings  #1)	J.R.R. Tolkien
The Fountainhead	Ayn Rand
The Game: Penetrating the Secret Society of Pickup Artists	Neil Strauss
The Gettysburg Address	Abraham Lincoln-Michael McCurdy
The Greatest Sailing Stories Ever Told: Twenty-Seven Unforgettable Stories	Christopher Caswell
The Heidi Chronicles	Wendy Wasserstein
The Heidi Chronicles: Uncommon Women and Others & Isn't It Romantic	Wendy Wasserstein
The Hitchhiker's Guide to the Galaxy (Hitchhiker's Guide to the Galaxy  #1)	Douglas Adams
The Hitchhiker's Guide to the Galaxy (Hitchhiker's Guide to the Galaxy  #1)	Douglas Adams-Stephen Fry
The Invention of Tradition	Eric Hobsbawm-Terence O. Ranger-Hugh Trevor-Roper-Prys Morgan-David Cannadine-Bernard S. Cohn
The John McPhee Reader (John McPhee Reader  #1)	John McPhee-William Howarth
The Kingdom of God Is Within You	Leo Tolstoy-Constance Garnett
The Kite Runner	Khaled Hosseini
The Known World	Edward P. Jones
The Known World	Edward P. Jones
The Known World	Edward P. Jones
The Known World	Edward P. Jones-Kevin R. Free
The Last Days of Pompeii	Edward Bulwer-Lytton-John Gregory Betancourt
The Locked Room (The New York Trilogy  #3)	Paul Auster
The Long Dark Tea-Time of the Soul (Dirk Gently  #2)	Douglas Adams
The Long Shadow (The Morland Dynasty  #6)	Cynthia Harrod-Eagles
The Lord of the Rings (The Lord of the Rings  #1-3)	J.R.R. Tolkien
The Lord of the Rings (The Lord of the Rings  #1-3)	J.R.R. Tolkien
The Lord of the Rings (The Lord of the Rings  #1-3)	J.R.R. Tolkien-Alan  Lee
The Lord of the Rings Box Set	J.R.R. Tolkien
The Lord of the Rings: Complete Visual Companion	Jude Fisher
The Lord of the Rings: Weapons and Warfare	Chris   Smith-Christopher  Lee-Richard Taylor
The Lost Continent: Travels in Small Town America	Bill Bryson
The Lovely Bones	Alice Sebold
The Lovely Bones	Alice Sebold
The Lover	Marguerite Duras-Barbara Bray-Maxine Hong Kingston
The Mini Rough Guide to London	Rob Humphreys-Beth Chaplin-Rebecca Morrill
The Moon is a Harsh Mistress	Robert A. Heinlein
The Mother Tongue: English and How It Got That Way	Bill Bryson
The Music of Chance	Paul Auster
The Names	Don DeLillo
The Natural	Bernard Malamud-Kevin Baker
The New York Trilogy	Paul Auster-Art Spiegelman-Luc Sante
The Notebooks of Lazarus Long	Robert A. Heinlein-Stephen Hickman
The Phantom Tollbooth	Norton Juster-Jules Feiffer
The Phantom Tollbooth: A Children's Play in Two Acts	Susan Nanus-Norton Juster
The Player's Handbook: The Ultimate Guide on Dating and Relationships	Heidi Fleiss-Libby Keatinge
The Plot Against America	Philip Roth
The Portrait of a Lady	Henry James-Gabriel Brownstein-Mary Cregan
The Portrait of a Lady	Henry James-Patricia Crick
The Power of One (The Power of One  #1)	Bryce Courtenay
The Power of One (The Power of One  #1)	Bryce Courtenay
The Power of One: One Person  One Rule  One Month	John C. Maxwell-Stephen R. Graves-Thomas G. Addington
The Power of One: The Solo Play for Playwrights  Actors  and Directors	Louis E. Catron
The Psychology of Everyday Things	Donald A. Norman
The Puffin Book of Nonsense Verse	Quentin Blake
The Ravishing of Lol Stein	Marguerite Duras-Richard Seever
The Red Notebook: True Stories	Paul Auster
The Road to Dune (Dune Universe)	Frank Herbert-Brian Herbert-Kevin J. Anderson
The Salmon of Doubt (Dirk Gently  #3)	Douglas Adams
The Taming of the Shrew	William Shakespeare-Chris Abraham-Barry Avrich
The Taming of the Shrew	William Shakespeare-Frances Barber-Roger Allam-Arkangel Cast
The Taming of the Shrew	William Shakespeare-Roma Gill
The Taming of the Shrew	William Shakespeare-Stephen Orgel-A.R. Braunmuller
The Tragedy of King Lear	William Shakespeare-Jay L. Halio
The Ultimate Hitchhiker's Guide (Hitchhiker's Guide to the Galaxy #1-5)	Douglas Adams
The Ultimate Hitchhiker's Guide to the Galaxy	Douglas Adams
The Ultimate Hitchhiker's Guide: Five Complete Novels and One Story (Hitchhiker's Guide to the Galaxy  #1-5)	Douglas Adams
The Untouchable	John Banville
The Untouchables	Eliot Ness-Oscar Fraley
The Virtue of Selfishness: A New Concept of Egoism	Ayn Rand-Nathaniel Branden
The War	Marguerite Duras-Barbara Bray-Ù‚Ù„Ø³Ù… Ø±ÙˆØ¨ÛŒÙ†
The Wedding Clause	Debbie Raleigh
The Westing Game	Ellen Raskin
The White Album	Joan Didion
The Year of Magical Thinking	Joan Didion
The Zebra Wall	Kevin Henkes
The Zen of CSS Design: Visual Enlightenment for the Web	Dave Shea-Molly E. Holzschlag
There's Always Enough: The Miraculous Move of God in Mozambique	Rolland Baker-Heidi Baker
Three Nights in August: Strategy  Heartbreak  and Joy Inside the Mind of a Manager	H.G. Bissinger
Timbuktu	Paul Auster
Timbuktu / Leviathan / Moon Palace	Paul Auster
Time for the Stars (Heinlein's Juveniles  #10)	Robert A. Heinlein
To Sail Beyond the Sunset	Robert A. Heinlein
Tolstoy: Anna Karenina	Anthony Thorlby
Traders  Guns & Money: Knowns and Unknowns in the Dazzling World of Derivatives	Satyajit Das
Travels in the Scriptorium	Paul Auster
Treasure Island	Robert Louis Stevenson
Treasure Island	Robert Louis Stevenson
Treasure Island	Robert Louis Stevenson-Milo Winter
Treasure Island	Robert Louis Stevenson-N.C. Wyeth-Timothy Meis
Treasure Island	Robert Louis Stevenson-Scott McKowen
Treasure Island (Great Illustrated Classics)	Deidre S. Laiken-A.J. McAllister-Robert Louis Stevenson
Tropic of Cancer	Henry Miller-JiÅ™Ã­ NÃ­l
Tropic of Capricorn	Henry Miller
Una arruga en el tiempo â€“ A Wrinkle in Time	Madeleine L'Engle
Unauthorized Harry Potter Book Seven News: "Half-Blood Prince" Analysis and Speculation	W. Frederick Zimmerman
Uncommon Carriers	John McPhee
Underworld	Don DeLillo
Untouchable	Mulk Raj Anand-E.M. Forster
Untouchables: My Family's Triumphant Journey Out of the Caste System in Modern India	Narendra Jadhav
V.	Thomas Pynchon
Vice (V  #8)	Jane Feather
Vineland	Thomas Pynchon
War and Peace	Leo Tolstoy-Henry Gifford-Aylmer Maude-Louise Maude
We Tell Ourselves Stories in Order to Live: Collected Nonfiction	Joan Didion-John Leonard
We Were Not Like Other People	Ephraim Sevela-Antonina W. Bouis
We the Living	Ayn Rand-Leonard Peikoff
What to Expect the First Year (What to Expect)	Heidi Murkoff-Sharon Mazel-Heidi Murkoff-Arlene Eisenberg-Sandee Hathaway-Mark D. Widome
What to Sell on ebay and Where to Get It: The Definitive Guide to Product Sourcing for eBay and Beyond	Chris Malta-Lisa Suttora
Where I Was From	Joan Didion
Why Write?	Paul Auster
Wish You Were Here: The Official Biography of Douglas Adams	Nick  Webb
Wizard: The Life and Times of Nikola Tesla: Biography of a Genius	Marc J.  Seifer-William H. Terbo
Wrinkles in Time	George Smoot-Keay Davidson
Zen and the Art of Motorcycle Maintenance: An Inquiry Into Values	Robert M. Pirsig
Zodiac	Neal Stephenson
eBay Business All-in-One Desk Reference for Dummies	Marsha Collier
eBay for Dummies	Marsha Collier
eBay: Top 100 Simplified Tips & Tricks	Julia Wilkinson
ebay Timesaving Techniques for Dummies	Marsha Collier
title	authors
